To see more details, see nuabashu.neocities.org
Alphabet:
a (“a” in father)\ á (“a” in ash) \ b \
c (“ts” in bits) \ ch (“ch” in check) \
d \ e (“e” in end)\ é (“e” in hey)\ f \ g 
\ gh (“j” in jar)\ h \ i (“ee” in
three)\ j (“y” in year) \ k \ l \ m \ n \
o (“o” in on) \ ó (“a” in fall) \ p \ q
(qu) \ r \ s \ sh (“sh” in shoot)\ t \ u
(“oo” in ooze)\ ú (“w” in win) \ v \ x
(“ch” in chrome) \ y (“a” in ado)\ z \
zh (“s” in measure)

Pronouns:
mú - I
nú - we
enú – exclusive “we”
sinú – singular “you”
vú – plural “you”
onú – “one”
igú - it
tarú – singular “they”
onarú – plural “they”

Suffixes and prefixes:
un-
opposite
re-
again
eks-
former state
mis-
error
anti-
against
ek-
sudden start
ret-
on the Internet
bo-
in-law
pra-
gen. before
fi-
shame
dis-
separate
-ich- (suffix)
male
-in- (suffix)
female
for-
away
-ul- (suffix)
person
-an- (suffix)
member
-ist- (suffix)
profession
-id- (suffix)
offspring
-estr- (suffix)
chief
-azh- (suffix)
thing/concrete
-qa- (suffix)
aquatic creature
-ar- (suffix)
collection
-er- (suffix)
element
-ej- (suffix)
place
-uj- (suffix)
container
-ec- (suffix)
quality
-ism- (suffix)
-qe- (suffix)
animal
-ebl- (suffix)
ability
-em- (suffix)
inclination
-ind- (suffix)
worthy
-end- (suffix)
duty
-ig- (suffix)
transistive
-izh- (suffix)
intransistive
pana-
dispenser
-et- (suffix)
small
-eg- (suffix)
large
-ach- (suffix)
pejorative
-ad- (suffix)
continuous
-um- (suffix)
other uses
-nj- (suffix)
female nickname
ge-
general
ksaiti-
horizontal
sid-
vertical
tiráks-
diagonal
balo-
good
-ip- (suffix)
gender neutral
-chj- (suffix)
nickname
(male)
-pj- (suffix)
nickname
(gender neutral)

Words and phrases:
alun - hello 
dartpomu - potato
dartu – ground, earth
mércun – thank you
gutá - good 
ungutá - bad
bashu - language
faré – to do 
pomu - apple 
numeru - number
da - yes,
emphasis
na - no, not
bananu - banana
cepu - onion
citronu - lemon
mogé – to drink
ebló – maybe (adverb)
ebla - maybe (expression)
esté – to be 
havé – to have
gutvenun - welcome
kabé – to eat 
juru - day 
semajnu - week
1 000 000 – lakú
1 000 000 000 – krorú
1 000 000 000 000 – trilionú
0 - nulú 
iré – to go 
snané – to take a shower
1 – úanú 
2 – dú 
3 – sanú 
4 – jonú 
5 – qinú 
6 – rokú
7 – likujú 
8 – atú 
9 – q 
10 – decú 
100 – centú 
1 000 – milú
murgenu - morning
avunu - afternoon
vunu - noon 
vesperu - evening
noktu - night
amseru - time
zorgé – to care, to worry
agé – to act 
treó - very 
tró – too much
deó - of 
daó – of (amount)
gecuju - Monday
kajubu - Tuesday
suijobu - Wednesday
mokujobu - Thursday
kinjuobu - Friday
dojuobu - Saturday
nichijoubu - Sunday
charo - because
kajo - and
pro - due to 
inse - in, inside
ekste - outside, out
echo - even 
poke - next to
poro - for 
anuo - or 
neko - neither 
keo - that
qazo - as if 
kamajé - to get
ungliju - finger
sedo - but 
seo - if 
sene - without
che - at 
je - at (time)
ale - to 
ele - from 
ole - than 
hinde - behind
ledenu - January
unoru - February
brezenu - March
dubenu - April
maju - May
chervenu - June
lipijecu - July
sirpenu - August
saru - September
rijenu - October
listopadu - November
prosinecu - December
janu - person
idu - child
ankoró - yet
tenminstó - at least
ekde - since
antaúe - before
poste - after
apude - left
dekstre - right
laúe - according to
kune - with
chirke - around
aprokse - approximately
sube - below
sure - on
intere - between
prie - about
krome - besides/except
trane - through
kromse - unless
anstataúe - instead
moje - more
unmoje - less
mejste - most
unmejste - least
mulapicu - pizza
busu - bus
garu - car
zheté - to throw
unhinde - in front of
tra - interjection
alakre - up
triste - down
deziré - to wish, to desire
frambu - raspberry
muru - wall
dzholu - water
chinijá - sweet
aliá - (an)other
demandé - to ask
baldó - soon
manku - lack of
juná - young
unjuná - old
dume - during
bejnaó - almost
apenó - barely
zhusó - just now
nuró - only
tujó - immediately
bise - until
lomaru - fox
rongu - colour
pimejá - black
lalá - red
nilá - blue
komolá - orange
rozá - pink
holudá - yellow
beguná - purple
shobujá - green
blanká - white
badamá - light brown
bruná - dark brown
altá - high/tall
brudu - bread
laktu - milk
retjoranilu - router
domu - house
anju - year
justá - right
lacá - tired
kelé - to play
historiu - history
kuiré - to cook
ideu - idea
oliné - to love
chiaoa - bye
adia - farewell
kushonu - pillow
edzu - married partner
kosté – to cost, to have a price
juru - Euro (currency)
uju - box
salu - salt
funkcié - to work, to function
laboré - to work
kanté – to sing
bravá - brave
úasou - bird
hejmu - home
trajnu - train
denovó - again
ligé - to link
luku - hand
noku - foot
kruré - to run
gambu - leg
ápelé - to call (on a phone)
okulu - eye
tetu - head
braku - arm
derevelé - to build
namu - name
keúselé - to speak
toké - to talk
babilé - to chat
ajdé - to help
krokodilé - to crocodile (not speaking Nuábashu in a Nuábashu environment)
geru - word
frazu - sentence
frazeru - phrase
retaru - internet
cirku - circle
sqaru - square
longá - long
longsqaru - rectangle
longcirku - elipsis
patru - parent
dostu - friend
telefonu - phone
luktelefonu - smartphone
telefonegu - tablet
komputé - to compute
komputilu - computer
komputiletu - laptop
televidé - to see a TV show
televidazhu - TV show
reteju - website
jasimá - opposite
jasimazhu - mirror
glajxá/glajxó - same
rajté - to be allowed
versuxé - to try
cerbu - brain
cerbumé - to think hard
listu - list
glaciu - ice
odorumé - to smell
odoru - smell
kalkulé - to count
kijetesantakalu - raccoon
sutopatikunu - platypus
pomotolu - tomato
tieá - local
hieró - yesterday
ogió - today
morgaúó - tomorrow
kareku - stone
benjetu - churro
vangu - cheek
frape’ - to hit
vangfrapé - to slap
avié - to fly
aviadilu - plane
kará - dear
matematiku/matu - maths
scienzu - science
kitabu - book
studé - study
kitabstudadu - literature
táku - money
tákeru - coin
plaché - to like
unplaché - to dislike
unoliné - to hate
oblé - to multiply
oné - to divide
adicé - to add
sybtrakté - to subtract
daúré - to continue
halté - to stop moving
chesé - to stop doing something
unmércebla - you’re welcome
fromadzhu - cheese
dalu(j) - lentil(s)
komencé - to begin
pakalé - to break
falé - to fall
tombé - to drop
unachá - nice
haptá - main
ritmu - rhythm
alikazó - on the other hand
úanú la aliá(n) - each other
chatu - cat
hundu - dog
foté - to take a photo
prené - to take
fotu - photo
bildu - picture
doloru - pain
monátu - month
bovu - bull
meté - to place
stosené - to push
tiré - to pull
konfituru - jam
jamó - already
hashiuj - chopsticks
vitru - (drinking) glass
huré - to hear
laúshé - to listen
sonu - sound
vivu - life
pácu - peace
legumu - vegetable
produktu - product
geá - general
isipiné - to think
vekizhé - to wake up
fratu - sibling
morté - to kill
bezoné - to need
konsilu - advice
nová - new
naské - to be born
tonu - tone
stiré - to drive
hajsá - hot
tandá - cold
fajru - fire
pinguinu - penguin
arbu - tree
arbetu - bush
gravá - important
necesá - necessary
unnecesá - unnecessary
cié - to know
dartstudu - geography
radiké - to root a number (maths)
unradiké - to power a number (maths)
vené – to come
pluo' - anymore
pavazhu - pavement
stratu - street
voju - road/way
mondu - world
pluvu - rain
pluvazhu - cloud
anté - to change
mamu - uncle/aunt
kuzu - cousin
malgraúe - despite
pere - by (use of)
transe - through
tajpé - to type
shrajbé - to write
muziku - music
musiá - fun
drolá - funny
lunu - moon
solu - sun
urbu - city
urbetu - town
dorfu - village
batalu - battle
batalegu - war
kajmanu - crocodile
atendé - to wait
pordu - door
lupu - hole
acheté - to buy
vendé - to sell
toleké - to be bored
tolekigé - to bore someone
erazé - to erase
chokuladu - chocolate
timigá - scary
timá - scared
suku - juice
fruktu - fruit
kapté - to catch
esperé - to hope
aperé - to appear
serché - to search
bestu - animal
celó - on purpose
machu - fish
fortá - strong
gazetu - magazine
glasu - glass (material)
horu - hour
minutu - minute
sekundu - second
instrué - to teach
informé - to inform
klasu - class
kongresu - congress
faku - subject
mezá - middle, moderate
fablá - kind, nice
unfablá - mean, unkind
uzé - to use
koru - core, heart
kabazhu - food
pepu - pipe
klubu - club
telu - oil
namaku - spice
acidá - acid, sour
unnamaká - bland
fermé - to close
apérté - to open
akesu - reptile
longakesu - lizard
trové - to find
chasé - to hunt
awené - to stay (in a state)
mojosá - cool
esuné - to trade
unpurá - dirty
purá - clean
sekurá - safe
unsekurá - dangerous
exu - echo
reflektazhu - reflection
mirindá - awesome
atbrakqau - octopus
sonachu - noise
foliu - leaf
dzholfrukto - watermelon
seperé - to seperate
kou - clay
pudru - powder
lalkoazhu - brick
konu - air
kulupu - community
kutu - ear
lanpané - to steal
lapé - to sleep
lenu - clothing
leneru - fabric
linju - line
libretu - leaflet
okulumé - to stare
rigardé - to look
vidé - to see
dartlupegu - sinkhole
panadzholu - sink
teru - Earth (planet)
egesu - health
egesilu - medicine
nasá - weird
nasegá - strange
nenu - hill
nenetu - bump
nenegu - mountain
esuneju - shop
bazaru - supermarket
esunejaru - market
senté - to feel (emotion)
tushé - to feel (physical), to touch
felichá - happy
unfelichá - sad
kolerá - angry
unkolerá - calm (describes a person)
tranqilá - calm (describes the environment)
kompleté - to complete
finé - to finish
detrué - to destroy
gúenegu - wasp
ciaru - knowledge
lecionu - lesson
pipu - bug
gúenu - bee
geujo - container
dzholujo - bottle
debreku - liquid
festu - solid
gekonu - gas
hajsgekonu - plasma
kompliká - complicated
unkompliká - simple
unglajxá - different
selá - blazing hot
letá - freezing cold
luftu - sky
sinpinu - face
unsinpinu - back (on body)
sitelenu - art
soku - mushroom
flaxsoku - fungus
flaxá - flat
bakteriu - bacterium
viru - virus
protistu - protist
liberá - free (not captured)
geprotistu - pathogen
soúelu - animal
gesupu - horizontal surface
gesinpinu - vertical surface
supu - table
utau - mouth
langu - tongue
dometu - cottage
domegu - mansion
ojuté - to kiss
utalé - to fight
úalá - bright
unúalá - dark
úeké - to exit
úilé - to want
forigé - to delete, to remove
lerné - to learn
sapu - soap
steu - stew
gesteu - soup
puledu - chicken
unlibereju - jail, prison
prau - prawn
praidu - shrimp
fumé - to smoke
alkohu - alcohol
alkohumogé - to drink alcohol
sofu - sofa
boshué - to sit
sezhu - chair
ápejá - cringe, awkward
usaúu - magic
levená - smooth
unlevená - rough
sulá - big
unsulá - small
Jena... - here is...
oficeju - office
qau - sea creature
qeu - mammal
muséu - museum
proprá - own
ajná - any
kelká - some
farté - to fare
Kie tú fartas? - How are you?
novigu - invention
fuáfuá - soft
unfuáfuá - hard
aresu - train track
chaloé - to walk
dzhaldá - fast
undzhaldá - slow
doráné - to run
do - so
oro - also
tandilu - fridge
letilu - freezer
kuirsupu - kitchen top
kuireju - kitchen
shajaneju - bedroom
kamarau - room
lekino - however
bejtakakanu - living room
komputilsupu - computer desk
patapradaré - to guide
déshu - land, country
bandahu - port
soriu - flipflop
vostu - tail
chiniju - sugar
moru - sea
padajé - to read
ásaná - easy
jurshangé - to update
avibandahu - airport
chijuró - every day
moregu - ocean
selou - border
morselou - coast
shajné - to seem
shajnó - apparently
ón - in a state of
akordu - agreement
mirindá - amazing
chochá - greedy
zumé - to zoom
sakané - can
tené - to hold
alporté - to bring
devré - should
porté - to wear
mutá - lots of
unmutá - not a lot of
palisu - stick
gedomu - building
gedomegu - skyscraper
sensoná - silent
garabaru - mess
átitu - past
vartamanu - present (time)
bavisju - future
gladé - to iron
gladilu - iron
kéndru - station
reón - (to the) back
panailo - vending machine
sidpalisu - pole
sidá - vertical
ksaitijá - horizontal
tiráksá - diagonal
hacardá - random
animácié - to animate
ebligé - to enable
panaumé - to give
jorané - to connect
nadiju - river
vijástá - busy (working)
populaciu - population
populacié - to populate
populaciitá - populated
cintidá - anxious
memu - self
ketu - field
kaju - platform
keksu - cookie
chinijazhu - candy (sweets)
ajlu - garlic
dahiju - yoghurt
ingu - (electrical) port
chaju - tea
kafu - coffee
akelá - alone
jojanu - plan
jaru - root
butu - ghost
baloá - nice
pilku - ball
tarafu - side
intencié - to mean
signifé - to signify
madu - honey
ritmu - rhythm, beat
foralasé - to leave
lasé - to let (someone do something)
plasénu - disc, disk
medau - memory
medailu USBá - USB stick
metru - metre
gramu - gram
chulau - hair
shirishu - glue
dakau - post
retdakau - e-mail
ajanau - panel
ciklu - bicycle
karu - motor
karciklu - motorcycle
argantiju - bank
argantijilu - ATM
katinplasénu - hard drive
grafikilu - GPU
grajnu - grain
kafgrajnu - coffee bean
grajnegu - bean
labormemoru - RAM (random access memory)
jahajau - ship
ulu - guy
natiju - file
natijuju - folder
arúilasé - to scan
arúilasilu - scanner
pardu - screen
isu - corn
pufisu - popcorn
teúlelé - to project
teúlelilu - projector
ajkataulu - calendar
ganigu - notification
krajonu - pencil
chefprocesoru - CPU
chapaé - to print
chapailu - printer
gesoriu - shoe
ghamu - shirt
lavreku - trousers
shinku - ham
bamghé - to fry
bamghshinku - bacon
upatau - data/datum
shrajbilu - pen
amkaé - to draw
ajempijá - previous, prior
seuravá - next
nukué - to nap
sahkoá - electrical
kortiju - card
vuodeu - bed
gejuhlau - celebration
jurkitabu - diary
vé - alas
jodinu - wire
matkajlu - travel
hipelé - to hop
kuvausu - description
kantaé - to translate
pajvau - date
usejnó - often
pirakau - pie
lausuaé - to recite
monijaó - many
sekao - as well as
ajkaó - not a lot
kucuaé - to invite
eké - to start
hanké - to plan a project, to design
hanku - project
litaita - related
litaé - to be related with
luodaé - to create
heraichu - mr.
herainu - ms.
herau - mx.
ichu - guy (male)
inu - guy (female)
ideigé - to inspire
juhlau - party
jakaé - to share
opituntiju - tutorial
opiaé - to learn
kelazhu - game
kerataé - to gather
ajnesu - ingredient
kuirilu - utensil
laulu - song
simboliju - symbol
huomatu - note
huomaté - to note
edotaé - to recommend, to suggest
edotaazhu - suggestion
ateljeu - studio
tojstuvá - frequent
pejtau - coat, jacket
tahmeá - sticky
kavau - equation
kavaé - to equate to
suhdeu - ratio
ajná - any
cirkselou - circumference
pitusu - length, diameter
duonpitusu - radius
decimalu - decimal
muotu - shape, form, layout
lomakeu - form (letter)
arvu - value, amount
vakiju - constant (maths)
palkaté - to give someone work
palkatantu - employer
palkatatu - employee
texnologiju - technology
tajdu - art
sotké - to involve
kilpajlé - to compete
kilpajlazhu - competition
cekaté - to check out
vierajlé - to visit
kurpicu - pumpkin
porena - day after
poreva - day before
siromu - star
siromqau - starfish
yhtiu - company, buisiness
kirjautué - to check in
ulosé - to check out (leave)
lahté - to depart
sapuaé - to arrive
oviju - gate
oju - egg
kejtaé - to boil
padelu - pan
gokijá - stupid
glosé - to sting, to smart
mekou - dress
veriju - blood
